         1111111111111111111111111
        1100000000110000000000001
        1011000001110000000010001
        1001000000000000000000001
111111111011000001110000000000001
100000000011000001110111111111111
11101111111110111000000100011
11110111111111011101010010001
11100000110101011100011110001111111111
  10000000000000001100011100010001   1
11100000000000001101011110001111111111
11000001110101011111011110N0111
11110111 1110101 101111010001
10111111 1111111 111 11111111
101   1
111111