1111111111111111111111111
1100000000110000000000011
101100000111000000N000001
1001000000000000000000001
1111111111111111111111111