111111111111111111111111111111111
100000000000000000000000000000001
100000000000000000000000000000001
100000000000000000000000S00000001
100001111111000000000000000000001
100000000001110000000000000000001
100000000000000000000000000000001
100000000000000000111100110000001
100000001000000000000000000000001
100000001000000000000000000000001
111111111111111111111111111111111