NO ./images_xpm/text_NO.xpm
SO ./images_xpm/text_SO.xpm
WE ./images_xpm/text_WE.xpm
EA ./images_xpm/text_EA.xpm

F 255,0,0
C 10,0,255

        1111111111111111111111111       
        1000000000011000000000001
        1000000001110000000000001
        1001000000000000000000001
111111111111000000000000000000001
100000000000000001110000111111111
100000000000000001110000111111111
11110000011111001100000000001
11110001111111001100000000001
11000000110101000000000010001
100000000000000000000000000011111111111
100000000000000011010100000010000000001
110000011100000111011110N00010000000001
11110111 1110101 1011100000011111111111
11110111 1110101 101111010001
11110111 1110101 101111010001
11110111 1110101 101111010001
11110111 1110101 101111010001
11110111 1110101 100000000001
11110111 1110101 100000000001
11110111 1110101 100000000001
11110111 1110101 101111010001
11110111 1110101 101111010001
11110111 1110101 101111010001
11110111 1110101 101111010001
11111111 1111111 111111111111
