111111111111111111111111111111111
100000000000000000000000000000001
100000000000000000000000000000001
100000001000000000000000S00000001
111111111000000000000000000000001
100000000000000000000001111100111
100000000000000000000001000000001
100000001111001100000001000000001
100000001000000100000001000000001
100000001000000100000001000001101
222222222222222222322222222322222