NO ./images_xpm/text_star_16.xpm
SO ./images_xpm/text_star_14.xpm
WE ./images_xpm/text_star_20.xpm
EA ./images_xpm/text_star_19.xpm

F 50,50,55
C 0,0,0




               11111
               10001
555545555555555500045555555555555   22222222
10000000000000000000000000000000555550000002
10000000000000000000000000000000000000000002
100000001000000000000000S0000000000000000003
11111111100000000000000000000000111110000002
100000000000000000000001111100111   12222222
100000000000000000000001000000001
100000001111001100000001100000001
100000001000001000011000100000001
100000001000001000041000100001101
100000001000001000000000100001101
222222222222222100000001222322222
              20000000002   
              20000000002
              20000000002
              22232222222